8
6
00333033
30333000
00000000
03333000
03333033
02000333

