9
9
000003333
333303333
000000000
033333330
033330000
020330000
033330000
000033330
000000000
