8
6
00333300
00333300
30302303
30000003
00300300
00333300
