9
7
033333333
000000333
033330333
030020000
030000000
030000000
003333333


