8
6
00003333
33303000
00303000
00000033
00303030
20303000
