8
6
00000033
33303333
00303000
00000030
00303030
00303020
