11
5
03003000333
03003000320
00000000000
33300300300
33300300300

