8
6
00000333
33330300
00000000
00033333
02033333
00033333
