9
7
033333333
002000333
033330333
030000000
030000000
030000000
003333333


