8
6
00000033
33303333
02303000
00000030
00303030
00303000
