9
7
030003000
030023000
033033303
000000003
303330333
000300033
000300033


