12
5
000000333330
333330333330
000000000000
203333333330
003333333330


