8
6
00333300
00333300
30300303
30000003
20300300
00333300
