8
5
00003333
33303000
00000000
00033000
00033200

