8
6
00333033
30333020
00000000
03333000
03333033
00000333

