10
6
0000003333
3333303333
0000000000
0333333330
0032000000
0030000000
