10
6
0000003333
3333303333
0000000000
2333333330
0030000000
0000000000
