10
5
0000333333
3330333333
0000000000
0033333302
0033333300



