8
6
03000300
03033332
00000000
33033033
30003003
30003003