8
6
00003333
33303002
00303000
00000033
00303030
00303000
